20 10
P...................
....................
....................
....................
.........WWWWWW.....
.........WGGGGW.....
.........WGGGGW.....
.........WGGGGW.....
.........WWWWWW.....
....................