20 10
P...................
.....W.. .. .....W..
...W...W............
.W... ...W.......W..
.W.......WWWWWW..W..
.W... ...WGGGGW..W..
.WW......WGGGGW.W...
..W......WGGGGWWW...
...W.....WWWWWW.....
.. .. ........ .. ..