20 20
P..W....GW..........
...W......W.........
...W.G... W.........
...W.     W.........
...WGW...W..........
...WWW..WW..........
...WWWWW............
...W.....W..........
...W......W.........
...W.......WW.W.....
.. W....G..WW.......
...W......WW...W....
...W.G...WW....W....
...W.WWWWW.....W....
...WGW.........W....
...WWW....WWWWWW....
.......W..W.........
.........W..........
..........W.........
....................
