40 20
P..W....G...........
...W......W.........
...W.G...W..........
...W.WWWWW..........
...WGW...W..........
...WWW..............
....................
....................
....................
....................