40 10
P..W....G...............................
...W......W.............................
...W.G...W..............................
...W.WWWWW..............................
...WGW...W..............................
...WWW..................................
........................................
........................................
........................................
........................................