20 10
P...................
....................
....................
....................
....................
..........GGGG......
..........GGGG......
..........GGGG......
....................
....................